                       ################
                       vvvvvvvvvvvvvvvv

            @  ##########            H########   @
        #######                      H       #########
   ######                            H          #########  
  ##^^^                $      +---===--+          ^^^##
   #####           +---===---+                   #####
    ###^^^                                   ^^^###
      ####^^^^^^^^^^^^^^^^^^^^^^^^^^^^^^^^^^^####
         ####################################
                       *
######################################################################
