*
#####         
      ##     ##    #  ##  #     #
@@@
#################################
                     ^^^^^^^^^^^     ###    
                    <###########            ####z
             ##             ###     ####
       ##        ##  #####    #          ###
 $   ##             #      ####               ##
####                #  @           #//////////#
^^^^^^^^^^^^^^^^^^^^############################
