
     ####################
z
  ##                      zzzzzzzzzzzzzzzzzzzzzzzz
##############
# @
##################^
#@                                     #
#######################z               #
#    $                                 #
#########################################
*                                          #     @       #
#########################################################
