
     ####################
z
  ##                      zzzzzzzzzzzzzzzzzzzzzzzz
##############
# @
##################^
#@                                     #
#######################z               #
#                   $                  #
#########################################
                                         * #     @       #
#########################################################
